NO ./textures/north.xpm

SO ./textures/south.xpm
WE ./textures/west.xpm

EA ./textures/east.xpm

F 220,100,0
C 100,100,50

11111111111
10000000001
10000000001
1000E000001
100010000011111
1001 1000000001
100010000000001
111111111111111
1000001
1000001
1111111