NO ./textures/north.xpm
SO ./textures/south.xpm
WE ./textures/west.xpm
EA ./textures/east.xpm
F  64,64,64
C 160,160,160

11111111111111
10000000111001
10111000111001
10100000001001
10101111101001
10101000001001
10101111101001
1010000000S001
10111000111001
10000000111001
10000000000001
11111111111111
