NO ./textures/north.xpm
SO ./textures/south.xpm
WE ./textures/west.xpm
EA ./textures/east.xpm

F 110,110,110
C 190,190,210

111111
100001
10N001
100001
111111
