R  8O0 six00   # letters instead of digits
NO ./textures/north.xpm
SO ./textures/south.xpm
WE ./textures/west.xpm
EA ./textures/east.xpm
S  ./textures/sprite.xpm
F  220,100,0
C  225,30,0

111111
10N001
100001
111111
